11111111
10000001
10433251
10000001
11111001
00001111
