01111111
01000001
01042401
11025201
10042401
10000001
11111111
